11000011111111000000000000000001
11111111111111111111111111111111
11000011111111000000000000000001
11100000000111000000000011111001
11100000100111000000000011111001
11100000100111000000000011111001
11100000000111000000000011111001
11000000000111000000000011111001
11000000000000000000000011111001
11111111000000000000000011111001
11111111000001111100000011111001
11000000000001111101110000000001
11000000000001111101110000000001
11000000000000000000000000000001
11111111110000000000000000000001
11111111110000000000000000000001
11111111110000000000011111110001
11111111110000000000011111110001
11111111110000000000011111110001
11111111110000000000011111110001
11111111110000000000000000000001
11111111110000000000000000000001
00111111111111111111111111111111
